abbasto (t): to walk along, to follow
abbomo (t): to affirm
abōl (m): fruit
addīksomi (a): to point at
ado (t): to lead
adros (m): field
ajgos (adj): sick, ill
ajos (n): metal
ajtomi (a): to possess, to own, to have
ajtos (n): spear, pike
akkapjo (t): to grasp, to hold
allekjo (t): to place, to collocate
allekso (t): to protect, to defend
allenxo (t): to hang (transitive)
allūko (t): to shine, to illuminate
alo (t): to nourish
alutu (n): beer
alφos (adj): white
ammōn (m): stone
amφis (f): snake
amφros (m): rain
an (n): air
anatis (f): duck
anemos (m): breath
anθus (adj): narrow, tight
anjos (adj): old
ankos (n): angle
annos (m): lamb
anomi (a): to breathe
antelo (t): to uncover, to discover, to find
antiterman (n): beginning
antjos (m): front, forehead
apos (adj): liquid
appretīpo (t): to face (direction)
apφenomi (a): to strike, to hit, to beat
apφero (t): to carry
apφlomo (t): to grow plants, to cause a plant to grow
apφūjo (t): to cause to grow
aris (f): nut
arkomi (a): to lock
aro (t): to plough
arotrom (n): instrument for ploughing
arrūpomi (a): to break, to hit, to strike
artos (m): bear
asgēn (m): breast, teat
askando (t): to leap
askapos (n): tool
askīdomi (a): to cut
asmeka (f): chin
asmeru (n): grease
asmīo (t): to laugh
asneo (t): to laugh
asnīφos (m): snow
asnomi (a): to swim
asnūan (n): sinew, tendon
asnūθos (n): mist
asnusa (f): daughter-in-law
aspekjo (t): to look at, to regard
aspergos (m): sparrow
aspēs (f): prosperity, luck
asplenθos (n): spleen
aspūo (t): to spit
astao (t): to stand
astego (t): to cover
astēr (m): star
asteφo (t): to stiffen
astīxo (t): to climb
astrenxo (t): to twine
astreφo (t): to gulp, to swallow
astroφo (t): to sip, to suck
astrūo (t): to flow
astūo (t): to hit
atus (adj): sharp
attenomi (a): to attain, to reach, to reach over, to reach for
atθutomi (a): to call
awa (f): grandmother
awgo (t): to enlarge
awgomi (a): to glance
awis (f): bird
awomi (a): to help
awos (m): grandfather
awsōs (f): dawn
axos (n): distress, fear
bao (t): come
baθo (t): to sink
bakom (n): staff
basto (t): to walk
belos (adj): powerful, strong
belφa (f): womb
bena (f): woman
benomi (a): to step, to take a step
bero (t): to praise
beru (n): spear
bīwo (t): to live
bīwos (m): life
bīwos (adj): alive, living
blūomi (a): to call
bomastao (t): to stand firmly
bomos (adj): strong, firm, steady
breθus (adj): short, brief
bruθomi (a): to bite
brus (adj): heavy
būo (t): to kiss
bus (m): cattle
galo (t): to call out
galus (adj): naked
gangomi (a): to mock
gelos (adj): cold
geris (f): crane (bird)
gerφo (t): to scratch
glaga (f): milk
glexo (t): divertir, to amuse
dajawēr (m): brother-in-law
dalexos (adj): long
danθwa (f): tongue
danomi (a): to be acquainted with, conocer
danosto (t): to recognize
danu (n): river
datru (n): tear in the eye
deksis (f): right (direction)
demo (t): to tame, domesticate
denomi (a): to beget, to produce, to give birth
denos (n): race, lineage, type, kind
denus (m): cheek
deo (t): to bind
despotus (m): master of the house
detos (adj): good
deφa (f): jaw
dīn (m): day
dīksomi (a): to point out
dīwos (m): god
djus (m): sky, heaven
do (t): to give
dōm (m): household, house
domφos (m): number
dono (t): to give
donom (n): gift
donos (m): offspring
dontus (m): tooth
donu (n): knee
doru (n): wood, tree
dranom (n): grain
drao (t): to run
dremo (t): to sleep
dūko (t): to lead
dūos (adj): beautiful
dūs (f): forearm
dusis (f): failure
dūstus (m): taste
dwojomi (a): to fear
edomi (a): to eat
eθus (adj): sharp
ellekjo (t): to put in, to insert
ellūkos (adj): enlightened (mind), wise
ellūφos (adj): sweet, caring, loving
embasto (t): to walk in, to enter
embīwos (adj): alive, living
embos (n): gland
enθūmos (adj): hot
enkasnos (adj): evil
enkretos (adj): talented, clever, able
enkrūos (adj): cold, cool
enswadīa (f): sugar
enswennjos (adj): sleepy, tired, fatigued, exhausted
entīomi (a): to live in, to habitate
entorpos (adj): happy
entrūdo (t): to impress (press in)
enudros (adj): wet, watery, liquid
enwerdjos (adj): energetic, active
ēr (m): goat
esan (n): blood
etwos (m): horse
θalomi (a): to blossom
θānis (f): goose
θaφīomi (a): to perish, to die
θeba (f): fat (grasa)
θejo (t): to suck
θelo (t): to shine
θeo (t): to put
θēr (m): hedgehog
θersos (adj): courageous
θēs (m): god, deity
θeφo (t): to burn
θīθo (t): to mold, to shape, to fashion
θīōm (f): winter
θo (t): to do, to make
θorsos (adj): courageous, valiant
θortos (m): enclosure
θrīo (t): to defecate
θrūxo (t): to trick, to deceive
θubros (adj): deep
θugatēr (f): daughter
θūlo (t): to pour
θūmos (m): smoke
θūo (t): to run
θutomi (a): to invoke
θūxomi (a): to work
θweros (m): wild animal
θweso (t): to breathe
θwōr (m): door
īomi (a): to go
isus (m): arrow
jados (adj): holy, saint
jedos (n): ice
jepan (n): liver
jēr (m): year
jesomi (a): to boil
jeφo (t): to copulate, to fuck
jugom (n): yoke
jugomi (a): to join, to tie together
jugos (n): team
jūenus (adj): young
kas (adj): blind
kalos (adj): handsome
kano (t): to sing
kantis (f): corner
kapjo (t): to grasp, to capture, to understand
kapros (m): goat
kasnos (adj): black, dark, dusky, obscure
kāt (m): puppy, cub
kedom (n): smoke
kela (f): glue
kenga (f): hook
kenkom (n): kneecap
kerpo (t): to pluck
klena (f): maple
klepo (t): to steal
klīo (t): to lean
klūnis (f): buttocks, hip, gluteus
klūo (t): to clean
klūomi (a): to hear, to listen
kobis (f): success
kotus (m): fight
kremom (n): onion
kretos (adj): intelligent, insightful, clever
krīomi (a): to separate
krūos (adj): raw
lāks (m): salmon
lamφros (adj): lightweight
lasus (adj): eager
latos (n): swamp
lawo (t): to wash
lawomi (a): to acquire
lebis (f): lip
lekso (t): to protect
lenθos (n): kidney
lenxo (t): to float
lekjo (t): to lay down, to put, to place
līgomi (a): to jump
līdomi (a): to bind
līθomi (a): to lick
līmōn (m): lake
linemos (adj): dirty
linepomi (a): to leave
līpo (t): to moisten
līsos (adj): straight
lokus (m): lake
lūdo (t): to break
lūθa (f): person
luθomi (a): to arrive
lūkos (m): light
lūφo (t): to love
lūxo (t): to lie, to tell a lie, to speak falsely
makos (n): pouch
mānis (f): moon
manu (n): human
matēr (f): mother
medomi (a): to consider
medus (adj): big, great
meθjos (m): middle
meldomi (a): to milk
melθos (m): lightning
melitu (n): honey
menomi (a): to think
mēns (m): month
mensos (n): meat
meromi (a): to die
mertis (f): death
mīθo (t): to urinate
mīos (adj): small
mōn (m): neck
moru (n): sea
mosxos (m): brain
moxomi (a): to be able, poder
moxos (adj): able, powerful
mūs (m): mouse
nasis (f): nose
nawis (f): boat, ship
nemos (n): sacrifice
nepōtis (f): granddaughter
nepōtus (m): grandson
nēr (m): power, force, vital energy
netomi (a): to attain, to reach
netus (adj): dead
neφos (n): cloud
neφros (m): kidney
nexa (f): fingernail
nisdos (m): nest
noman (n): name
noptis (f): night
noφilos (m): navel
numan (n): breath, soul, spirit
nūos (adj): new
ojnomi (a): to join together, to join, to unite
oju (n): lifetime
olos (n): elbow
ombāl (m): charcoal
omban (n): butter, fat
ombo (t): to anoint
omos (adj): bitter
onkos (m): bend, turn
onos (n): load, burden
ōpis (f): eye
orōn (m): eagle
orφos (m): orphan
osdos (m): branch
ōs (f): mouth
ostu (n): bone
otris (f): corner
owis (f): sheep
ōwos (n): ear
pakko (t): to duck
pao (t): to protect
pasomi (a): to cough
pasto (t): to interrogate, to question
pastro (t): to sneeze
patēr (m): father
pawan (n): fire
pedomi (a): to tread
pegan (n): breast
pela (f): skin
pelis (f): flour
pentos (m): road
peplos (m): wheel, circle
perbasto (t): to walk through, to penetrate
perdomi (a): to fart
permenomi (a): to think through, to brainstorm, to think intensely
perpontōm (m): transcurso, time
persom (n): dust
perta (f): rib
pesus (m): penis
petan (n): feather
peto (t): to take away
petomi (a): to fly
petu (n): livestock
pipo (t): to drink
pisda (f): vulva
pistis (f): fish
pjeos (adj): quiet
plako (t): to punch, to strike, to hit
plenos (adj): full
pletus (adj): flat, broad
plōtus (m): flood
plūmōn (m): lung
plusis (f): flea
plūtos (adj): rich
po (t): to cook
podis (f): foot
pontōm (m): track, path, road
portos (m): pig
potus (m): master
pretīpos (m): face
preto (t): to pray, to ask
prinomi (a): to buy
prīomi (a): to like
prīa (f): happiness
prīos (adj): happy
prūo (t): to jump
prūso (t): to freeze
pula (f): hair
rādis (f): root
rapa (f): turnip
rebīa (f): darkness
rebos (adj): dark
rēdus (m): king, ruler
repomi (a): to snatch
reφomi (a): to build
rodos (adj): straight
ros (adj): sharp
rūgomi (a): to vomit
ruθros (adj): red
rūpomi (a): to break
sagomi (a): to seek, to search
sagjo (t): to give a sign
sāl (m): salt
sawsos (adj): dry
sedomi (a): to sit
sellekjo (t): to put together, to assemble, to build
selpa (f): butter
sema (f): summer
semado (t): to conduct, to lead
seman (n): seed
sembasto (t): to walk together, to march
sembomo (t): to confirm
semjugomi (a): to unite, to join together
semjummantis (f): union
semφeθjo (t): to compete
senos (adj): old
sentrūdo (t): to compress
seo (t): to sow
sepomi (a): to follow
sexomi (a): to hold
sīo (t): to sift
sisdo (t): to sit down (transitive)
sjūo (t): to sew
somi (a): to be
somos (adj): same, alike
sotan (n): dung, excrement
sowan (n): sun
sūnus (m): son
suros (adj): sour
swadīa (f): sweetness
swadus (adj): sweet
swelomi (a): to burn
swennos (m): sleep, slumber
swepo (t): to sleep
swepomi (a): to throw
swerxos (adj): ill, sick
swesōr (f): sister
sweturos (m): father-in-law
swīdomi (a): to sweat
swīo (t): to whistle
tado (t): to hate
tadomi (a): to fall
tago (t): to touch
tarko (t): to twist
tarnos (adj): sharp
tasus (adj): grey
tatis (f): battle
tawo (t): to melt
tawros (m): bull, bison
tegus (adj): thick
telus (adj): warm
telo (t): to cover, to hide
tengomi (a): to think
tenomi (a): to extend
tenus (adj): thin
tepos (n): heat, warmth
terman (n): boundary, end
ternom (n): horn
tero (t): to cross over
tersus (adj): dry
tēru (n): heart
terus (adj): sterile
tīno (t): to lie, to settle
tīomi (a): to settle, to populate, to dwell
tolomi (a): to hold up, to lift
tona (f): shell
tonos (m): string, chord, fiber
torpos (adj): satisfied, pleased
torsos (adj): dry
traomi (a): to mix
traso (t): to run
trebom (n): dwelling
tremo (t): to tremble, to shake
tristus (adj): in a bad mood
trūdo (t): to press
tūsjo (t): to spy
tūta (f): tribe, people
tuφom (n): shoulder
twenos (adj): holy
twōn (m): dog
ubbasto (t): to walk out, to exit
udros (adj): wet
ūjom (n): egg
ūkomi (a): to say
uksēn (m): ox
ūomi (a): to dress
uperallenxo (t): to hang (transitive)
upertolomi (a): to sustain, to hold over, to support
uperūkomi (a): to yell, to scream
upūkomi (a): to whisper
ūsomi (a): to burn
waθomi (a): to go
walena (f): wool
walpos (m): wolf
watomi (a): to blow
wapos (adj): bad, evil
wardjo (t): to work
warmis (f): worm
wedos (adj): wet
weθo (t): to transport
weleo (t): to wish, to want, to desire
weo (t): to blow
wepo (t): to speak
werdom (n): work
werθom (n): word
weros (adj): true
werus (adj): broad
wesgeros (m): evening
wesomi (a): to wear
wetos (n): season
weφo (t): to weave
weφomi (a): to praise
wīdomi (a): to know, saber
wīdos (adj): wise
wiθwa (f): widow
wīkomi (a): to be victorious over, vencer
wīmos (adj): twisty
winθa (f): elm
wīnom (n): wine
wiros (m): man
wīsomi (a): to sprout
wīspotus (m): village chief, landlord, lord
wītis (f): village
wītos (adj): bright
wītso (t): to see
wodan (n): water
womis (f): wind
wōpis (f): voice
wōr (m): raven
wortomi (a): to turn (transitive)
wosan (n): spring (season)
φago (t): to divide
φadis (f): beech
φados (adj): good
φaθa (f): leg
φao (t): to shine
φāp (f): bean
φarθa (f): beard
φaros (adj): warm, hot
φarsis (f): barley
φeθjo (t): to request, to ask for
φeθomi (a): to dig
φelos (adj): bright
φenθus (adj): thick
φenomi (a): to strike down, to kill, to slay
φerθo (t): to protect
φerθontus (adj): high, tall
φerjos (adj): hot, warm
φero (t): to carry
φeφrus (m): beaver
φīa (f): bee
φīdomi (a): to split, to separate
φīθo (t): to trust, to be confident in
φleo (t): to cry
φlīdo (t): to shine
φlomo (t): to flower, to blossom
φlotos (m): flower
φogo (t): to bake, roast
φōr (m): thief
φratēr (m): brother
φrūan (n): well, spring, source, fountain
φrūis (f): eyebrow
φugo (t): to escape
φūdo (t): to hit, to strike
φūθos (adj): awake, aware
φūjo (t): to grow
φummēn (m): bottom
φūomi (a): to become
φūxo (t): to bend
xajdos (m): young goat
xeθōm (m): earth
xelo (t): to call
xeφo (t): to take
xlūo (t): to joke
xrenθom (n): beam (structure)
xreo (t): to grow (of plants)
xostus (m): stranger
